NO ./sprites/north_wall.xpm
SO ./sprites/south_wall.xpm
WE ./sprites/wall.xpm
EA ./sprites/east_wall.xpm
F 125,200,100
C 140,0,100

1111111111
1PC0CCCW01
1111111111
