WE ./sprites/wall2.xpm
NO ./sprites/wall3.xpm
SO ./sprites/wall4.xpm
EA ./sprites/wall1.xpm

C 225,255,255
F 0,0,0



111111111111
1C000000000111111
1000e000000000011
11100000000000111
111100000e0000111
1111111D111111111   111111111111111111111111
1C0000000000000001  10e0000000000000000000C1
10000000e0000000001 100eeeee000000H000011111
10000000000000000001100000000000000000001111
111111111110e000000D00000HHHHHH0000000W00001
1111111111111110000110000000000000000000C111
11111111111111111111111111111111111111111111