EA ./sprites/east_wall.xpm
C 140,130,100
SO ./sprites/south_wall.xpm
WE ./sprites/wall.xpm
F 125,200,100
NO ./sprites/north_wall.xpm

11111111
10000001
1eeee001
10000001
1N000001111111111111111111111111111111111111111111111111111111111111111
10000000000000000000000000000000000000000000000000000000000000000000001
11111111111111111111111111111111111111111111111111111111111111111111111
