NO ./sprites/north_wall.xpm
SO ./sprites/south_wall.xpm
WE ./sprites/wall.xpm
EA ./sprites/east_wall.xpm
F 125,200,100
C 140,130,100

11111111
1CCCCCN1
11111111