NO ./sprites/wall2.xpm
SO ./sprites/wall2.xpm
WE ./sprites/wall2.xpm
EA ./sprites/wall2.xpm
F 0,0,0
C 225,255,255

1111111111111111111111111
1000000000110000000000001
101100e001110000000000001
 1001000000000000000000001
 10000e00001100000000e0001
1011000001110000000000001
100100000000000000000000111111111
111111111011000001110000000000001
100000000011000001110111110011111
11110111111111011100000010001
11110111111111011101010010001
11000000110101011100000010001
1000000000000000110000e010001
10000000000000001101010010001
1100000111010101111101111000111
100000000011000000000000100001111
101100000111000000000000100000001
 100100000000000000000e00100000001
 111111111011000001110000000000001
 100000000011000001110111110111111
 11110111111111011100000010001
 11110111111111011101010010001
 11000000110101011100000010001
 10000000000000001100000010001
 10000000000000001101010010001
 110000011101010111110111100011111
111111111011000001110000000000001
10000000001100000111011111D111111
1111011111111101110000001CCC1
1111011111111101110101001eC01
110000001101010111000000D00C1
10000000000000001100000010001
10000000000000001101010010001
11000001110101011101011010N0111
11110111 1110101 101111010001
11111111 1111111 111111111111
