WE ./sprites/wall.xpm
NO ./sprites/north_wall.xpm
SO ./sprites/south_wall.xpm
EA ./sprites/east_wall.xpm

C 225,255,255
F 0,0,0


1111111111111111111111111
1000C00000110000000000001
101100e001110000000000001
 1001000000000000000000001
 10000e00001100000000e0001
1011000001110000000000001
100100000000000000000000111111111
111111111011000001110000000000001
100000000011000001110111110011111
11110111111111011100000010001
11110111111111011101010010001
11C00000110101011100000010001
1000000000000000110000e010001
10000000000000001101010010001
1100000111010101111101111000111
100000000011000000000000100001111
1011000001110000P0000000100000001
 100100000000000000000e001000000C1
 111111111011000001110000000000001
 100000000011000001110111110111111
 11110111111111011100000010001
 11110111111111011101010010001
 11000000110101011100000010001
 10000000000000001100000010001
 10000000000000001101010010001
 110000011101010111110111100011111
111111111011000001110000000000001
1C000000001100000111011111D111111
11110111111111011100000010001
1111011111111101110101001eee1
110000001101010111000000D0H01
10000000000000001100000010H01
10000000000000001101010010001
11000001110101011101011010N0111
11110111 1110101 101111010001
11111111 1111111 111111111111
