EA ./sprites/east_wall.xpm
C 140,130,100
SO ./sprites/south_wall.xpm
WE ./sprites/wall.xpm
F 125,200,100
NO ./sprites/north_wall.xpm

 1 1 1 1 1 1 1

1100000000N011
11111111111111