EA ./sprites/east_wall.xpm
C 140,130,100
SO ./sprites/south_wall.xpm
WE ./sprites/wall.xpm
F 125,200,100
NO ./sprites/north_wall.xpm

111
101
101
1N1
1111
101
101
101
111
111
111
111
111
11
11
1111
111
111
111
111
111
111
111
111
11
11
1111
111
111
111
111
1s1
111
111
111
11
11
1111